24 24 45 17
0 0 0 0 -1 0 0 0 0 0 -1 0 0 0 0 -1 0 0 0 -1 0 0 0 0
0 0 0 0 -1 0 0 6 0 0 -1 0 7 0 0 -1 0 0 0 -1 0 0 8 0
0 0 0 -1 -1 0 0 0 0 0 -1 0 0 0 0 -1 0 0 0 0 0 0 0 0
0 0 0 0 0 0 0 0 0 0 -1 0 0 0 0 -1 0 0 0 0 0 0 0 0 
0 S 0 0 0 4 0 0 0 0 -1 0 0 0 1 0 0 0 0 0 -1 0 0 0
0 0 0 0 0 -1 0 0 F2 0 0 2 0 0 1 0 0 0 0 0 0 0 0 0
0 0 0 0 0 -1 0 0 0 0 0 -1 0 0 0 0 0 5 0 0 0 -1 0 0
0 0 0 0 0 -1 0 0 0 -1 -1 -1 0 0 0 -1 0 0 0 0 0 0 -1 0 
0 0 0 4 0 0 0 0 0 0 -1 0 0 0 0 -1 0 0 0 F0 0 0 -1 0 
-1 0 0 0 0 0 0 0 0 0 -1 0 0 0 0 -1 -1 0 0 0 0 0 0 0
-1 0 6 0 0 0 0 0 -1 -1 0 0 -1 0 0 -1 0 0 0 0 0 0 -1 0
-1 0 0 0 0 -1 -1 -1 -1 -1 0 0 -1 0 0 0 0 0 0 0 0 0 0 0
0 0 0 0 0 0 -1 0 0 -1 0 0 0 0 0 0 -1 0 0 0 -1 0 10 0
-1 -1 -1 0 0 0 -1 0 0 -1 0 0 7 0 0 0 -1 0 0 0 -1 0 0 0
0 0 -1 0 F1 0 -1 0 0 -1 0 0 0 0 0 5 0 0 0 0 -1 0 0 0
0 0 0 0 0 0 -1 0 0 -1 0 -1 -1 -1 0 -1 -1 -1 0 0 0 0 0 0
0 0 1 4 3 2 -1 0 0 -1 0 0 -1 0 0 -1 0 -1 0 0 0 0 F5 0
0 0 0 0 0 0 -1 0 0 -1 0 0 -1 0 0 -1 0 0 0 0 0 -1 0 0
0 0 0 0 -1 0 -1 0 0 0 0 0 -1 0 0 -1 0 0 4 0 0 0 0 0
0 0 0 0 -1 0 -1 0 0 0 0 0 -1 0 0 -1 0 0 0 0 -1 0 0 0
0 0 0 0 -1 0 0 0 0 F3 0 0 0 0 0 0 0 3 -1 0 -1 0 G 0
0 -1 -1 -1 -1 0 0 8 0 0 0 0 0 0 0 -1 0 0 0 0 -1 0 0 0
0 0 0 0 0 0 0 0 0 -1 0 0 0 0 0 0 -1 0 0 0 0 0 0 0
0 0 -1 -1 0 0 0 0 0 0 0 0 0 0 0 0 -1 0 0 0 F0 0 0 0



