10 10 22 8
0 0 0 0 0 0 0 0 0 0
0 0 0 0 4 0 0 -1 0 0 
0 0 0 -1 -1 0 0 -1 0 -1
0 0 0 0 -1 F2 -1 -1 0 0
0 0 0 0 -1 0 0 0 0 0
0 0 S 0 -1 0 0 0 0 0
0 0 0 0 -1 0 0 G 0 0
0 -1 -1 0 -1 0 0 0 0 0
0 0 0 0 -1 -1 -1 -1 -1 F1
0 0 0 0 1 5 0 1 0 0