10 10 25 10 
0 0 0 F0 1 6 0 0 -1 0
0 0 0 -1 -1 -1 0 0 0 0
0 S 0 0 0 0 -1 0 0 0 
0 0 0 0 0 9 0 0 0 0
0 0 0 0 F1 -1 0 0 0 0
0 0 0 0 -1 0 0 4 0 0
-1 -1 -1 0 0 -1 0 0 G 0 
-1 -1 -1 0 0 -1 0 0 0 0 
0 0 0 10 0 -1 0 0 0 0
0 0 0 0 0 0 -1 0 0 0