10 10 22 0
0 0 0 0 0 0 0 0 0 0
0 0 0 0 4 0 0 -1 0 0 
0 0 0 -1 -1 0 0 -1 0 -1
0 0 0 0 -1 0 -1 -1 0 0
0 0 0 0 -1 0 0 0 0 0
0 0 S 0 -1 0 0 0 0 0
0 0 0 0 -1 0 0 G 0 0
0 -1 -1 0 -1 0 0 0 0 0
0 0 0 0 -1 -1 -1 -1 -1 0
0 0 0 0 1 5 0 1 0 0